../Bomberman/Ressources/Texture/textLevelTileMap.png
11
11
16
16
2
1 1
9 1
0 0 0 0 0 0 0 0 0 0 0
0 3 3 3 1 3 3 1 3 3 0
0 3 3 2 1 3 1 3 1 3 0
0 3 3 2 1 3 3 3 3 2 0
0 3 3 1 1 1 1 3 2 2 0
0 3 3 3 2 3 3 3 3 1 0
0 3 1 2 1 3 1 3 1 1 0
0 3 2 2 1 3 3 3 3 1 0
0 3 1 3 1 3 1 3 1 1 0
0 3 3 1 1 1 1 1 3 3 0
0 0 0 0 0 0 0 0 0 0 0

