../Bomberman/Ressources/Texture/textTileMap.png
11
11
16
16
4
0 0
16 0
32 0
48 0
0 0 0 0 0 0 0 0 0 0 0
0 2 2 2 1 2 2 2 2 1 0
0 2 0 2 0 2 0 2 0 1 0
0 2 2 2 1 2 2 2 2 1 0
0 2 0 1 0 2 0 2 0 1 0
0 2 2 2 2 2 2 2 2 1 0
0 2 0 2 0 2 0 2 0 1 0
0 2 2 2 1 2 2 2 2 1 0
0 2 0 2 0 2 0 2 0 1 0
0 2 2 1 1 1 1 1 2 2 0
0 0 0 0 0 0 0 0 0 0 0

