../ProjetBomberman/Ressources/Texture/textTileMap.png
10
10
16
16
4
0 0
16 0
32 0
48 0
0 0 0 0 0 0 0 0 0 0
0 2 2 2 1 2 2 2 2 0
0 2 2 2 1 2 1 2 2 0
0 2 2 2 1 2 2 2 2 0
0 2 2 1 1 2 1 2 2 0
0 2 2 2 2 2 2 2 2 0
0 2 2 2 2 2 1 2 2 0
0 2 2 2 1 2 2 2 2 0
0 2 2 2 2 2 1 2 2 0
0 0 0 0 0 0 0 0 0 0

