../Bomberman/Ressources/Texture/textLevelTileMap.png
11
11
16
16
4
1 1
9 1
1 9
9 9
0 0 0 0 0 0 0 0 0 0 0
0 3 3 3 1 3 3 3 3 3 0
0 3 3 3 1 3 1 3 3 3 0
0 3 3 2 1 3 3 2 3 3 0
0 3 1 1 1 1 1 3 2 3 0
0 3 3 3 2 3 3 3 3 3 0
0 3 1 2 1 3 1 3 1 3 0
0 3 3 2 1 3 3 1 3 3 0
0 3 3 3 1 3 1 3 3 3 0
0 3 3 3 1 1 1 3 3 3 0
0 0 0 0 0 0 0 0 0 0 0

